##################
##################
##################
########    ######
######## ## ######
########$   ######
#####@$   # ######
#####$$## # ######
##### ..  # ######
#####.#.$  .######
#####   ##########
##################
