##################
##################
##################
##################
######@  #########
######.$* ########
######    ########
######    ########
##################
##################
##################
##################