##################
#########.########
######### #  #####
########   $ #####
########      ####
########   .   ###
## $.* # $ #.  ###
##@### #  .  $ ###
##  ## $   #######
##     #  ########
##################
##################
