##################
##################
############@#####
############$#####
############.#####
############ #####
############  ####
###  *     $. ####
#####    $..$ ####
##################
##################
##################

