##################
###########.  ####
########### # ####
#######   # # ####
#### * *# $*# ####
####@       $ ####
###### ## ## .####
###### ##     ####
###### ##   $ ####
###### .   #######
##################
##################
