#############
########  ###
########  ###
######## ####
###### . ####
######$ $####
#  . ..  $ ##
###### &   ##
######  #$ ##
####### $%###
#############
