##################
##################
###### $ .########
##### .## ########
#####    .$+######
#####  $ ##*######
######   ## ######
######*      #####
###### $  ########
######    ########
##################
##################

