##################
##################
##################
##################
########    ######
#######  ## ######
####### $.$. #####
######## #   #####
######## @ #######
##################
##################
##################
