##################
##################
##################
######## @ #######
#######.  $* #####
####### # .# #####
####### . $# #####
####### #  # #####
#######   $  #####
####### ## #######
#######    #######
##################
