##################
#####@############
#####$############
#####     ########
##### $   ########
##### $   ########
##### ##.  #######
#####. # # #######
#### $   # #######
#### # $ # #######
#### ... $.#######
##################
