##################
######   .  ######
###### *$ #$######
###### $.   ######
###### ###  ######
###### ###* ######
######*#### ######
######@####.######
########### ######
########### ######
##################
##################
