##################
##################
##########..   ###
########   ##$ ###
######## $  .$ ###
###+ $   .###$ ###
########   ##  ###
########  . $ ####
##################
##################
##################
##################
