##################
##################
##################
##################
##################
######.  ##   ####
#####   *$    ####
##### .$ #########
#######@ #########
##################
##################
##################
