##################
##################
###    ###########
### $# ###########
### *. ###########
######.  ##    ###
#####   *$    *###
##### .$ #########
#######@ #########
##################
##################
##################
