##################
##################
#######@##########
####.  $##########
####  .   ########
####  # # ########
####  # # ########
#### .   *########
##### $#$ ########
#####    #########
##################
##################
