##################
###########.  ####
########### # ####
########### # ####
######### $*# ####
####@       $ ####
###### ## ## .####
###### ##     ####
###### ##   $ ####
###### .   #######
##################
##################
