##################
##################
##################
######.   ########
######  $ ########
######+#$#########
######  $ ########
######.   ########
##################
##################
##################
##################

