##################
####### . ########
#### $  $ ########
#### ## $ $ ######
####     # . #####
#######      #####
########.#. @ ####
########   #######
##################
##################
##################
##################
