##################
######### $.######
######### # ######
#####     #.######
##### ##  #$######
#####$#    .######
#####@#   ########
##### $.  ########
##### ##  ########
##### ##$  #######
#####.$  . #######
##################
