##################
#####@* .  #######
#####$#   $#######
#####.# ##.$ #####
##### #    # #####
##### .$ $ # #####
########     #####
############ #####
############.#####
##################
##################
##################
