##################
######## #########
######## #########
######## @ #######
#######.  $* #####
####### # .#    ##
####### . $# #####
##   ** #  # #####
#######   $  #####
####### ## #######
#######    #######
##################
