##################
########.#########
####     #########
### .$ # #########
### ## # #########
### ##  .$@#######
### ## # #########
###  $ # #########
#### $ . #########
##################
##################
##################

