##################
##################
##################
######. ##########
######. ##########
######@$  ########
###### $  ########
######  ##########
##################
##################
##################
##################