##################
##################
##################
# *.  .   $ .  $.#
########  $ #.##@#
######## #     $$#
######## #### ## #
######## ####    #
######## #########
##################
##################
##################

