##################
###########  #####
###########  #####
########### ######
######### . ######
#########$ $######
####  . ..  $ ####
######### *   ####
#########  #$ ####
########## $+#####
##################
##################
