##################
##################
#######. @  ######
#######$##$$ #####
####. .$ $.# #####
#######. $ # #####
########.# # #####
#######      #####
####### #  #######
#######    #######
##################
##################
