##################
######   .  ######
###### *$ # ######
###### $.   ######
###### ###  ######
###### ###########
######*###########
######@###########
##################
##################
##################
##################
