##################
##################
##################
##################
######   .  ######
###### *$ # ######
######@$.   ######
##################
##################
##################
##################
##################
