##################
##################
######## $.* #####
#####    ###@#####
#####  .   $ #####
######.# ##$$#####
###### #   $ #####
###### #  ##.#####
###### .     #####
##################
##################
##################
