##################
##################
#######   ########
#### $ $..########
#### $ $ #########
####  ##.    #####
####   *  .$ #####
###### ## ########
######@  .########
##################
##################
##################
