##################
#####@* .  #######
#####$#   $#######
#####.# ##.$ #####
##### #    # #####
##### .$ $ # #####
########     #####
###########  #####
########### .#####
############ #####
##################
##################
