##################
##################
######.  $ #######
######       $.###
###### .### ## ###
######   ## ## ###
###### .    ## ###
##*. $ ## $ $  ###
##   #    @   ####
##################
##################
##################
