##################
##################
#####       ######
##### #$.$$ ######
##### # ##. ######
##### # ##  ######
##### .. #$ ######
###### #$ @#######
######.  $########
####### . ########
##################
##################
