##################
######.  #########
##### .# #########
#####  .  $ ######
###### $### ######
######$* ## ######
######      $@####
#####.  ##########
##################
##################
##################
##################
