##################
##################
#######   ########
#### $ $..########
#### $ $ #########
####  ##. ########
####   *  ########
###### ## ########
######@  .########
##################
##################
##################
