##################
##################
##################
##################
######### . ######
#########$ $######
######. ..  $ ####
######### *   ####
#########  #$ ####
############@#####
##################
##################
