##################
##################
##################
##################
##################
######.  #   #####
#####   *$   #####
##### .$ #########
#######@ #########
##################
##################
##################
