##################
##################
#########     ####
#### $@.#$ #  ####
#### # *.  $* ####
#### #. #     ####
#### #* ##########
####    ##########
####### ##########
##################
##################
##################

