##################
##################
############@#####
#########   $#####
#########$##.#####
######### ## #####
#########.##  ####
###  *     $. ####
#####    $..$ ####
##################
##################
##################

