##################
##################
##################
######  ##########
######  ##########
######.$##########
###### @  ########
######.$# ########
#######   ########
##################
##################
##################