##################
##################
##################
##################
######.    .######
######   $$ ######
#########@  ######
##################
##################
##################
##################
##################