#############
########  ###
########  ###
######## ####
###### . ####
######$ $####
#  . ..  $ ##
###### *   ##
######  #$ ##
####### $+###
#############
