##################
######..$ ########
######.##.########
######    ########
###### #* ########
#### $     $ @####
####   $$ ########
#### ### #########
####. ## #########
####     #########
##################
##################
