##################
########.  #######
####     #$#######
### .$ # # #######
### ## # #.#######
### ##  .  $  ####
### ## # # ## ####
###  $ # # ## ####
#### $ . # ##@####
########## .$ ####
##################
##################

