##################
##################
##################
##################
######### . ######
#########$ $######
#########.    ####
######### *@  ####
#########  #######
##################
##################
##################
