##################
##################
#######@# $. #####
####.  $# ## #####
####  .   ## #####
####  # # ## #####
####  # # *  #####
#### .   *########
##### $#$ ########
#####    #########
##################
##################
