##################
##################
##################
#####.@* #########
#####$  $ ########
#####   # ########
#####  .  ########
##################
##################
##################
##################
##################


