##################
##################
##################
########    ######
######## $.* ..###
### $  .    ######
### ###@$$ #######
###  ##  * #######
###     ##########
##################
##################
##################
