##################
##################
##########   #####
##.@$      . #####
######## ##  * ###
######## $ * # ###
########   $ * ###
########.#########
######## #########
######## #########
##################
##################
