##################
##################
##################
##################
#######.. ########
########  ########
###### $  ########
###### $ #########
######@  #########
##################
##################
##################