##################
##################
###    ###########
### $# ###########
### *. ###########
######.  ##   ####
#####   *$    ####
##### .$ #########
#######@ #########
##################
##################
##################
