##################
######   @ #######
###### ###$#######
######  ##.#######
###### $ ..#######
########$$ #######
########   #######
########$$.#######
#######   .#######
#######    #######
####### .#########
##################
