##################
##################
##################
######  ##########
###### @##########
######.$##########
######    ########
######.$# ########
#######   ########
##################
##################
##################