##################
##################
#############    #
############# ## #
#############.## #
#############$## #
#####            #
#.@ $.  $ $ ######
#####. # #$#######
#####  $.. #######
##################
##################
