##################
##################
##################
###.  .   $ .  $.#
########  $ #.##@#
##########     $$#
############# ## #
#############    #
##################
##################
##################
##################

