##################
###      .  ######
### ##  ### $. ###
###. $   ## ## ###
#### $# $     .###
####  #### # #####
#########@$. #####
#########$## #####
######### ## #####
######### ## #####
#########.   #####
##################
