##################
##################
##################
##################
########    ######
######## ...######
####### $$$ ######
####### @ ########
##################
##################
##################
##################