##################
########  ########
########  $ ######
####### $.# ######
####### # . ######
######    . ######
###### #$$* ######
######. $@########
######  ##########
######. ##########
##################
##################
