##################
####### . ########
#### $  $ ########
#### ## $ $ ######
####     # . #####
#######      #####
########.#. @ ####
########   ##*####
########## ## ####
########## ## ####
########## $. ####
##################
