###################
###################
###################
###################
########.##########
######## ##########
#####. $$$  .######
####### @  ########
########$##########
########.##########
###################
###################