##################
##################
#########   ######
######### # ######
#######  $  ######
#######.# $#######
#######+#  #######
#####   # ..######
######*$$ $ ######
##### .     ######
##################
##################

