##################
########## #######
##########@#######
##########$#######
###.    .$  * ####
#########* $  ####
######## * ## ####
########      ####
########## ##.####
##########    ####
##################
##################
