##################
#####     ########
##### $## $ ######
######.##.  ######
###### ## ########
###### @  ########
#####    #########
##### ##.#########
#####  $ #########
##### $$.#########
##### $..#########
##################
