##################
########.  #######
####     #$#######
### .$ # # #######
### ## # #.#######
### ##  .  $ @####
### ## # #########
###  $ # #########
#### $ . #########
##################
##################
##################

