##################
##################
##########@#######
##########$#######
#######..$  * ####
########## $  ####
########## ## ####
##########    ####
########## ##.####
##########    ####
##################
##################
