##################
######.  #########
##### .# #########
#### * .  $ ######
#### # $### ######
#### #$* ## ######
#### #      $@####
#### .  ##########
#### #############
#### #############
##################
##################
