##################
##################
########  . ######
########   $######
####### $$  ######
##### $+* $ ######
##### ### . ######
#####  ## ..######
#####     ########
##################
##################
##################

